....o...oo.....o...o..o.oxxx....o...oo.....o...o..o.o.......
o...oo.....o...o..o.o....xxxo...oo.....o...o..o.o.......o...
oo.....o...o..o.o.......oxxxoo.....o...o..o.o.......o...oo..
...o...o..o.o.......o...oo.....o...o..o.o.......o...oo.....o
...o..o.o.......o...oo.....o...o..o.o.......o...oo.....o...o
..o.o.......o...oo.....o...o..o.o.......o...oo.....o...o..o.
o.......o...oo.....o...o..o.o.......o...oo.....o...o..o.o...
....o...oo.....o...o..o.o.......o...oo.....o...o..o.o.......
o...oo.....o...o..o.o.......o...oo.....o...o..o.o.......o...
oo.....o...o..o.o.......o...oo.....o...o..o.o.......o...oo..
...o...o..o.o.......o...oo.....o...o..o.o.......o...oo.....o
...o..o.o.......o...oo.....o...o..o.o.......o...oo.....o...o
..o.o.......o...oo.....o...o..o.o.......o...oo.....o...o..o.
o.......o...oo.....o...o..o.o.......o...oo.....o...o..o.o...
....o...oo.....o...o..o.o.......o...oo.....o...o..o.o.......
o...oo.....o...o..o.o.......o...oo.....o...o..o.o.......o...
oo.....o...o..o.o.......o...oo.....o...o..o.o.......o...oo..
...o...o..o.o.......o...oo.....o...o..o.o.......o...oo.....o
...o..o.o.......o...oo.....o...o..o.o.......o...oo.....o...o
..o.o.......o...oo.....o...o..o.o.......o...oo.....o...o..o.
o.......o...oo.....o...o..o.o.......o...oo.....o...o..o.o...
....o...oo.....o...o..o.o.......o...oo.....o...o..o.o.......
o...oo.....o...o..o.o.......o...oo.....o...o..o.o.......o...
oo.....o...o..o.o.......o...oo.....o...o..o.o.......o...oo..
...o...o..o.o.......o...oo.....o...o..o.o.......o...oo.....o
...o..o.o.......o...oo.....o...o..o.o.......o...oo.....o...o
..o.o.......o...oo.....o...o..o.o.......o...oo.....o...o..o.
o.......o...oo.....o...o..o.o.......o...oo.....o...o..o.o...
....o...oo.....o...o..o.o.......o...oo.....o...o..o.o.......
o...oo.....o...o..o.o.......o...oo.....o...o..o.o.......o...
oo.....o...o..o.o.......o...oo.....o...o..o.o.......o...oo..
...o...o..o.o.......o...oo.....o...o..o.o.......o...oo.....o
...o..o.o.......o...oo.....o...o..o.o.......o...oo.....o...o
..o.o.......o...oo.....o...o..o.o.......o...oo.....o...o..o.
o.......o...oo.....o...o..o.o.......o...oo.....o...o..o.o...
....o...oo.....o...o..o.o.......o...oo.....o...o..o.o.......
o...oo.....o...o..o.o.......o...oo.....o...o..o.o.......o...
oo.....o...o..o.o.......o...oo.....o...o..o.o.......o...oo..
...o...o..o.o.......o...oo.....o...o..o.o.......o...oo.....o
...o..o.o.......o...oo.....o...o..o.o.......o...oo.....o...o
..o.o.......o...oo.....o...o..o.o.......o...oo.....o...o..o.
o.......o...oo.....o...o..o.o.......o...oo.....o...o..o.o...
....o...oo.....o...o..o.o.......o...oo.....o...o..o.o.......
o...oo.....o...o..o.o.......o...oo.....o...o..o.o.......o...
oo.....o...o..o.o.......o...oo.....o...o..o.o.......o...oo..
...o...o..o.o.......o...oo.....o...o..o.o.......o...oo.....o
...o..o.o.......o...oo.....o...o..o.o.......o...oo.....o...o
..o.o.......o...oo.....o...o..o.o.......o...oo.....o...o..o.
o.......o...oo.....o...o..o.o.......o...oo.....o...o..o.o...
....o...oo.....o...o..o.o.......o...oo.....o...o..o.o.......
o...oo.....o...o..o.o.......o...oo.....o...o..o.o.......o...
oo.....o...o..o.o.......o...oo.....o...o..o.o.......o...oo..
...o...o..o.o.......o...oo.....o...o..o.o.......o...oo.....o
...o..o.o.......o...oo.....o...o..o.o.......o...oo.....o...o
..o.o.......o...oo.....o...o..o.o.......o...oo.....o...o..o.
o.......o...oo.....o...o..o.o.......o...oo.....o...o..o.o...
....o...oo.....o...o..o.o.......o...oo.....o...o..o.o.......
o...oo.....o...o..o.o.......o...oo.....o...o..o.o.......o...
oo.....o...o..o.o.......o...oo.....o...o..o.o.......o...oo..
...o...o..o.o.......o...oo.....o...o..o.o.......o...oo.....o
