.o.oo...oo.ooxxoo..o..o.ooo..o.oo...oo.oo..oo..o..o.ooo..o.o
o...oo.oo..ooxxo..o.ooo..o.oo...oo.oo..oo..o..o.ooo..o.oo...
oo.oo..oo..o..o.ooo..o.oo...oo.oo..oo..o..o.ooo..o.oo...oo.o
o..oo..o..o.ooo..o.oo...oo.oo..oo..o..o.ooo..o.oo...oo.oo..o
o..o..o.ooo..o.oo...oo.oo..oo..o..o.ooo..o.oo...oo.oo..oo..o
..o.ooo..o.oo...oo.oo..oo..o..o.ooo..o.oo...oo.oo..oo..o..o.
ooo..o.oo...oo.oo..oo..o..o.ooo..o.oo...oo.oo..oo..o..o.ooo.
.o.oo...oo.oo..oo..o..o.ooo..o.oo...oo.oo..oo..o..o.ooo..o.o
o...oo.oo..oo..o..o.ooo..o.oo...oo.oo..oo..o..o.ooo..o.oo...
oo.oo..oo..o..o.ooo..o.oo...oo.oo..oo..o..o.ooo..o.oo...oo.o
o..oo..o..o.ooo..o.oo...oo.oo..oo..o..o.ooo..o.oo...oo.oo..o
o..o..o.ooo..o.oo...oo.oo..oo..o..o.ooo..o.oo...oo.oo..oo..o
..o.ooo..o.oo...oo.oo..oo..o..o.ooo..o.oo...oo.oo..oo..o..o.
ooo..o.oo...oo.oo..oo..o..o.ooo..o.oo...oo.oo..oo..o..o.ooo.
.o.oo...oo.oo..oo..o..o.ooo..o.oo...oo.oo..oo..o..o.ooo..o.o
o...oo.oo..oo..o..o.ooo..o.oo...oo.oo..oo..o..o.ooo..o.oo...
oo.oo..oo..o..o.ooo..o.oo...oo.oo..oo..o..o.ooo..o.oo...oo.o
o..oo..o..o.ooo..o.oo...oo.oo..oo..o..o.ooo..o.oo...oo.oo..o
o..o..o.ooo..o.oo...oo.oo..oo..o..o.ooo..o.oo...oo.oo..oo..o
..o.ooo..o.oo...oo.oo..oo..o..o.ooo..o.oo...oo.oo..oo..o..o.
ooo..o.oo...oo.oo..oo..o..o.ooo..o.oo...oo.oo..oo..o..o.ooo.
.o.oo...oo.oo..oo..o..o.ooo..o.oo...oo.oo..oo..o..o.ooo..o.o
o...oo.oo..oo..o..o.ooo..o.oo...oo.oo..oo..o..o.ooo..o.oo...
oo.oo..oo..o..o.ooo..o.oo...oo.oo..oo..o..o.ooo..o.oo...oo.o
o..oo..o..o.ooo..o.oo...oo.oo..oo..o..o.ooo..o.oo...oo.oo..o
o..o..o.ooo..o.oo...oo.oo..oo..o..o.ooo..o.oo...oo.oo..oo..o
..o.ooo..o.oo...oo.oo..oo..o..o.ooo..o.oo...oo.oo..oo..o..o.
ooo..o.oo...oo.oo..oo..o..o.ooo..o.oo...oo.oo..oo..o..o.ooo.
.o.oo...oo.oo..oo..o..o.ooo..o.oo...oo.oo..oo..o..o.ooo..o.o
o...oo.oo..oo..o..o.ooo..o.oo...oo.oo..oo..o..o.ooo..o.oo...
oo.oo..oo..o..o.ooo..o.oo...oo.oo..oo..o..o.ooo..o.oo...oo.o
o..oo..o..o.ooo..o.oo...oo.oo..oo..o..o.ooo..o.oo...oo.oo..o
o..o..o.ooo..o.oo...oo.oo..oo..o..o.ooo..o.oo...oo.oo..oo..o
..o.ooo..o.oo...oo.oo..oo..o..o.ooo..o.oo...oo.oo..oo..o..o.
ooo..o.oo...oo.oo..oo..o..o.ooo..o.oo...oo.oo..oo..o..o.ooo.
.o.oo...oo.oo..oo..o..o.ooo..o.oo...oo.oo..oo..o..o.ooo..o.o
o...oo.oo..oo..o..o.ooo..o.oo...oo.oo..oo..o..o.ooo..o.oo...
oo.oo..oo..o..o.ooo..o.oo...oo.oo..oo..o..o.ooo..o.oo...oo.o
o..oo..o..o.ooo..o.oo...oo.oo..oo..o..o.ooo..o.oo...oo.oo..o
o..o..o.ooo..o.oo...oo.oo..oo..o..o.ooo..o.oo...oo.oo..oo..o
..o.ooo..o.oo...oo.oo..oo..o..o.ooo..o.oo...oo.oo..oo..o..o.
ooo..o.oo...oo.oo..oo..o..o.ooo..o.oo...oo.oo..oo..o..o.ooo.
.o.oo...oo.oo..oo..o..o.ooo..o.oo...oo.oo..oo..o..o.ooo..o.o
o...oo.oo..oo..o..o.ooo..o.oo...oo.oo..oo..o..o.ooo..o.oo...
oo.oo..oo..o..o.ooo..o.oo...oo.oo..oo..o..o.ooo..o.oo...oo.o
o..oo..o..o.ooo..o.oo...oo.oo..oo..o..o.ooo..o.oo...oo.oo..o
o..o..o.ooo..o.oo...oo.oo..oo..o..o.ooo..o.oo...oo.oo..oo..o
..o.ooo..o.oo...oo.oo..oo..o..o.ooo..o.oo...oo.oo..oo..o..o.
ooo..o.oo...oo.oo..oo..o..o.ooo..o.oo...oo.oo..oo..o..o.ooo.
.o.oo...oo.oo..oo..o..o.ooo..o.oo...oo.oo..oo..o..o.ooo..o.o
o...oo.oo..oo..o..o.ooo..o.oo...oo.oo..oo..o..o.ooo..o.oo...
oo.oo..oo..o..o.ooo..o.oo...oo.oo..oo..o..o.ooo..o.oo...oo.o
o..oo..o..o.ooo..o.oo...oo.oo..oo..o..o.ooo..o.oo...oo.oo..o
o..o..o.ooo..o.oo...oo.oo..oo..o..o.ooo..o.oo...oo.oo..oo..o
..o.ooo..o.oo...oo.oo..oo..o..o.ooo..o.oo...oo.oo..oo..o..o.
ooo..o.oo...oo.oo..oo..o..o.ooo..o.oo...oo.oo..oo..o..o.ooo.
.o.oo...oo.oo..oo..o..o.ooo..o.oo...oo.oo..oo..o..o.ooo..o.o
o...oo.oo..oo..o..o.ooo..o.oo...oo.oo..oo..o..o.ooo..o.oo...
oo.oo..oo..o..o.ooo..o.oo...oo.oo..oo..o..o.ooo..o.oo...oo.o
o..oo..o..o.ooo..o.oo...oo.oo..oo..o..o.ooo..o.oo...oo.oo..o
